(
        "       P                                                   P                  P      T  T  T  T  T  T T                                          P                                           P                                                                                                                  ",
        "                                                                                                                                                        P      T T T  T  T T                                                                                                                                   E",
        "    *                                          T                               T                                                                              T                 TP                                                                                                   T                          ",
        "  PPPP   PPZPP  PT  PPP P P P PTP   P P PP T  TP    P  T  P  P Z Z Z Z Z Z    P     P  P  P  P  P  P  T P PT  P P P PT  P P P PT  Z Z Z       T  P  T           T                          T          P P P ZZZZ       T      P P ZT    PT   P P P ZT   ZT   ZT   ZT   ZT       P PTP     P Z  ZT           P   ",
        "                                                                                                                                                                                                                                                                                                                ",
)
